R 1920 1080

F 255,0,255
C 232,0,254

111111
100101
102001
1100N1
111111

NO textures/texture
SO textures/texture
EA textures/texture
WE textures/texture
S textures/texture