R 1000 700

F 128,128,128
C 100,180,255

11111111111111111111
10000000000000000001
10000000000000000001
10000000000000000001
10000000000000000001
10000000000000000001
10000000100000000001
10000000000000000001
10000000000000000001
10000000N00000000001
10000000000000000001
10000000000000000001
10000000000000000001
10000000000000000001
10000000000000000001
10000000000000000001
10000000000000000001
10000000000000000001
10000000000000000001
11111111111111111111

NO textures/north.xpm
SO textures/south.xpm
EA textures/east.xpm
WE textures/west.xpm
S textures/bookshelf.xpm