R 1000 700

NO textures/north.xpm
SO textures/east.xpm
WE textures/north.xpm
EA textures/east.xpm

S textures/tonneau.xpm
F 128,128,128
C 100,180,255


S2 textures/heart32.xpm
S3 textures/trap.xpm
S4 textures/champ.xpm
W0 textures/cup0.xpm
W1 textures/cup1.xpm
W2 textures/cup2.xpm
GG textures/win.xpm
HUD textures/hud.xpm
HEART_EMPTY textures/heart_empty.xpm

11111111111111111111
10000000000000000001
10000000000000000001
10000000000000000001
10000000000000000001
11010101010101010101
10000000000000000001
10101010101010101011
10000000000000000001
10000001S10000000001
10000000000000000001
10009000000000056001
10000000000000000001
10004444433333330001
10004444433333330001
10000000000000000001
10002000020002000001
10000000000000000001
10002000020002000001
11111111111111111111