R 1000 1F4

NO textures/north.xpm
SO textures/east.xpm
WE textures/north.xpm
EA textures/east.xpm

S textures/tonneau.xpm
F 128,128,128
C 100,180,255

11111111111111111111
10111111111111111111
10000000044400000001
10111111111111111101
10451415141413141191
10131000043400000131
10111011111111110131
10000040003000000101
11311111019111111141
10040001N10000000101
11110111115011111101
10000000000001004001
10311111111111311111
10000040000001000401
11111111111111111011
11111105000030000011
11000011111111111011
11411010000000111411
12621000111110003001
11111101111111111111
11111100000000300001
11111111111111111101
10000000444000000001
13111111111111111111
13305000000044444001
11111111111111111131
11111111111111111111