R 1000 700

F 128,128,128
C 100,180,255

11111111111111111111
10111111111111111111
10000000000000000001
10111111111111111101
10001000000000000151
10101000000000000101
10111011111111110101
10000000000000000101
11011111015111111101
10000001N10000000101
11111111100001111101
10000000000001000001
10000000000001011111
10000000000001000001
10000000000001111011
11111000000000000011
11000000001111111011
11011000000000111011
12020000001110000001
11111111111111111111

NO textures/north.xpm
SO textures/south.xpm
EA textures/east.xpm
WE textures/west.xpm
S textures/pillar.xpm
HE textures/heart32.xpm
TR textures/trap.xpm